######################################################################
#.................................#..................................#
#.................................#..................................#
#.................................#..................................#
#.................................#..................................#
#.................................#..................................#
#....................................................................#
#....................................................................#
#................#..................................#................#
#.................#................................#.................#
#..................#..............................#..................#
#...................#............................#...................#
#....................#..........................#....................#
#.....................#........................#.....................#
#......................#......................#......................#
#.......................#....................#.......................#
#....................................................................#
#....................................................................#
#....................................................................#
#.......................#....................#.......................#
#......................#......................#......................#
#.....................#........................#.....................#
#....................#..........................#....................#
#...................#............................#...................#
#..................#..............................#..................#
#.................#................................#.................#
#................#..................................#................#
#....................................................................#
#....................................................................#
#.................................#..................................#
#.................................#..................................#
#.................................#..................................#
#.................................#..................................#
#.................................#..................................#
######################################################################