######################################################################
#....................................................................#
#....................................................................#
#....................................................................#
#........###########..............................###########........#
#........#..................................................#........#
#........#..................................................#........#
#........#..................................................#........#
#........#..................................................#........#
#........#..................................................#........#
#....................................................................#
#....................................................................#
#....................................................................#
#....................................................................#
#....................................................................#
#....................................................................#
#....................................................................#
#....................................................................#
#....................................................................#
#....................................................................#
#....................................................................#
#....................................................................#
#....................................................................#
#....................................................................#
#....................................................................#
#........#..................................................#........#
#........#..................................................#........#
#........#..................................................#........#
#........#..................................................#........#
#........#..................................................#........#
#........##########...............................###########........#
#....................................................................#
#....................................................................#
#....................................................................#
######################################################################